1111111111111
10*1000000001
1000011111001
1000*1E00C0P1
1111111111111
