1111111111111111111111111111111111
1E0000000000000C00000C000000000001
101001010010000010*001000000010101
10q00*00101010q0001000!~~@00010101
1P0000000C00C0000000000000000000C1
101001010010000010*C01000000010101
10100q010**000001000010000000101*1
1111111111111111111111111111111111
